qwr="
|--------|--------|--------|--------|--------|--------|                     |--------|--------|--------|--------|--------|--------|
|     TAB|       Q|       W|       E|       R|       T|                     |       Y|       U|       I|       O|       P|       `|
|--------|--------|--------|--------|--------|--------|                     |--------|--------|--------|--------|--------|--------|
|     MEH|       A|       S|       D|       F|       G|         QWR         |       H|       J|       K|       L|       ;|       '|
|--------|--------|--------|--------|--------|--------|                     |--------|--------|--------|--------|--------|--------|
|    LCTL|       Z|       X|       C|       V|       B|                     |       N|       M|       ,|       .|       /|     ENT|
|--------|--------|--------|--------|--------|--------|--------|   |--------|--------|--------|--------|--------|--------|--------|
                                    |    LGUI|LALT/ESC| SYM/SPC|   |NUM/BSPC|OSM/LSFT|    RCTL|
                                    |--------|--------|--------|   |--------|--------|--------|
"
sym="
|--------|--------|--------|--------|--------|--------|                     |--------|--------|--------|--------|--------|--------|
|     TAB|       !|       @|       #|       (|       ^|                     |       \|       )|       -|       +|       =|       ~|
|--------|--------|--------|--------|--------|--------|                     |--------|--------|--------|--------|--------|--------|
|     MEH|       &|       $|       %|       [|       _|         SYM         |       ||       ]|       /|       *|       :|       "|
|--------|--------|--------|--------|--------|--------|                     |--------|--------|--------|--------|--------|--------|
|    LCTL|    MCR0|    MCR1|    MCR2|       {|       <|                     |       >|       }|       ,|       .|       ?|     ENT|
|--------|--------|--------|--------|--------|--------|--------|   |--------|--------|--------|--------|--------|--------|--------|
                                    |    LGUI|LALT/ESC|    TRNS|   |    TMUX|    LSFT|    RCTL|
                                    |--------|--------|--------|   |--------|--------|--------|
"
num="
|--------|--------|--------|--------|--------|--------|                     |--------|--------|--------|--------|--------|--------|
|     TAB|       1|       2|       3|       4|       5|                     |    MPRV|    VOLD|    VOLU|    MNXT|    MPLY|     WWW|
|--------|--------|--------|--------|--------|--------|                     |--------|--------|--------|--------|--------|--------|
|     MEH|       0|       9|       8|       7|       6|         NUM         |    LEFT|    DOWN|      UP|   RIGHT|    MUTE|    WFWD|
|--------|--------|--------|--------|--------|--------|                     |--------|--------|--------|--------|--------|--------|
|    LCTL|    UNDO|     CUT|    COPY|    PSTE|   CADEL|                     |     AF4|    BRID|    BRIU|    TTY1|    TTY2|    WBAK|
|--------|--------|--------|--------|--------|--------|--------|   |--------|--------|--------|--------|--------|--------|--------|
                                    |    LGUI|LALT/ESC|    TRNS|   |    TRNS|    LSFT|    RCTL|
                                    |--------|--------|--------|   |--------|--------|--------|
"
nav="
|--------|--------|--------|--------|--------|--------|                     |--------|--------|--------|--------|--------|--------|
|    TRNS|   MBTN1|   MBTN3|   MBTN2|    BOOT|  CG/NRM|                     |    MWHL|    MWHD|    MWHU|    MWHR|    HOME|     INS|
|--------|--------|--------|--------|--------|--------|                     |--------|--------|--------|--------|--------|--------|
|      F1|      F2|      F3|      F4|      F5|      F6|         NAV         |    MCRL|    MCRD|    MCRU|    MCRR|     END|     DEL|
|--------|--------|--------|--------|--------|--------|                     |--------|--------|--------|--------|--------|--------|
|     F12|     F11|     F10|      F9|      F8|      F7|                     |    NUML|    PGDN|    PGUP|    SCRL|    PSCR|     ENT|
|--------|--------|--------|--------|--------|--------|--------|   |--------|--------|--------|--------|--------|--------|--------|
                                    |    LCTL|    LALT|     SPC|   |    BSPC| OSM/SFT|    LGUI|
                                    |--------|--------|--------|   |--------|--------|--------|
"
afk="
|--------|--------|--------|--------|--------|--------|                     |--------|--------|--------|--------|--------|--------|
|     TAB|       Q|       W|       E|       R|       T|                     |       Y|       U|       I|       O|       P|       `|
|--------|--------|--------|--------|--------|--------|                     |--------|--------|--------|--------|--------|--------|
|     ESC|       A|       S|       D|       F|       G|         AFK         |       H|       J|       K|       L|       ;|       '|
|--------|--------|--------|--------|--------|--------|                     |--------|--------|--------|--------|--------|--------|
|    RCTL|       Z|       X|       C|       V|       B|                     |       N|       M|       ,|       .|       /|     ENT|
|--------|--------|--------|--------|--------|--------|--------|   |--------|--------|--------|--------|--------|--------|--------|
                                    |    LSFT|    LALT|     SPC|   |NUM/BSPC| SYM/ESC|    RGUI|
                                    |--------|--------|--------|   |--------|--------|--------|
"
